{
	"label": "NSW Premier’s Reading Challenge 2025: Level K-2",
	"description": "NSW Premier’s Reading Challenge 2025: Level K-2,  complied by Woollahra Public Library-May 2025",
	"isbns": [
 "9781922613509",
        "9781922696380",
        "9781922539502",
        "9781761211188",
        "9781925868821",
        "9781925868401",
        "9781925868609",
        "9781925868180",
        "9780734422019",
        "9780733343476",
        "9780734422101",
        "9781460764060",
        "9780063264618",
        "9781529509588",
        "9781761211959",
        "9781925936032",
        "9781922643544",
        "9780063237490",
        "9781922539748",
        "9781529508727",
        "9781761180323",
        "9781760658953",
        "9781922610768",
        "9781922610669",
        "9781760656171",
        "9781447284437",
        "9781922777294",
        "9781922142955",
        "9781761180880",
        "9781761341700",
        "9780358588771",
        "9780063136540",
        "9781925563740",
        "9780702266355",
        "9780734421494",
        "9780733343001",
        "9781536234091",
        "9781761212505",
        "9780734421807",
        "9781761211881",
        "9781761111518",
        "9781922539700",
        "9781839133268",
        "9780702268311",
        "9781922539847",
        "9781626722866",
        "9781760655099",
        "9781760657260",
        "9781760656195",
        "9781761293047",
        "9781760656416",
        "9781761212024",
        "9781761212017",
        "9781761212031",
        "9781761211980",
        "9781760651770",
        "9781760658052",
        "9781922858535",
        "9780734421548",
        "9781875641697",
        "9781761212239",
        "9780734423085",
        "9781922863966",
        "9781788008402",
        "9781761180927",
        "9781761521621",
        "9781925936483",
        "9781760764647",
        "9781536219494",
        "9781761210037",
        "9781760507411",
        "9781761213496",
        "9781760507329",
        "9781761210051",
        "9781761213489",
        "9781761211058",
        "9780734423023",
        "9781761180903",
        "9781761213113",
        "9781486316762",
        "9781761180309",
        "9781409550501",
        "9781761111686",
        "9781761111693",
        "9780734421883",
        "9781760653392",
        "9781761180606",
        "9780734422491",
        "9781776575947",
        "9781761068126",
        "9781761068119",
        "9781760659462",
        "9781529525243",
        "9781760978488"
	]
}
