{
    "label": "NSW Premier Reading Challenge 2025: Level K-2",
    "description": "NSW Premier Reading Challenge 2025: Level K-2, complied by Woollahra Public Library-May 2025",
    "isbns": [
        "9780008390679",
        "9780008702465",
        "9781922790996",
        "9781922458520",
        "9781760657369",
        "9781529500769",
        "9781921098437",
        "9781460762745",
        "9781922643001",
        "9781760656409",
        "9781760666125",
        "9781922777218",
        "9780008646578",
        "9781529502688",
        "9781761181351",
        "9781761181344",
        "9781761347481",
        "9781761347498",
        "9781761347443",
        "9781761347436",
        "9781804661352",
        "9781529523782",
        "9781529505498",
        "9781761068942",
        "9781761069833",
        "9781761069857",
        "9781761069918",
        "9781761211713",
        "9781922142306",
        "9780008608903",
        "9781760266486",
        "9780008582081",
        "9781761343568",
        "9781761111624",
        "9780008534301",
        "9780063057777",
        "9780358470113",
        "9781920878573",
        "9781922777249",
        "9780063224544",
        "9781486315444",
        "9781761067860",
        "9781760659257",
        "9781761128516",
        "9781760974619",
        "9781761205002",
        "9781760269364",
        "9781761123252",
        "9781338762587",
        "9781761122255",
        "9781338356144",
        "9781761203978",
        "9781338315196",
        "9781338356182",
        "9781761560132",
        "9780008520878",
        "9781921288029",
        "9781460765074",
        "9781761292620",
        "9781761521591",
        "9781460763179",
        "9781529518313",
        "9781921417184",
        "9780008639006",
        "9781760802899",
        "9780008475994",
        "9780008476076",
        "9781761213588",
        "9781460766415",
        "9781922385062",
        "9781760655686",
        "9781486317141",
        "9781536226157",
        "9781922790712",
        "9781922790569",
        "9781761180347",
        "9781869715564",
        "9781460714331",
        "9780733342097",
        "9780645133158",
        "9780645133189",
        "9780008561277",
        "9781529523249",
        "9781460764435",
        "9781761068607",
        "9781760526566",
        "9781760526573",
        "9781760526580",
        "9781804661079",
        "9780008565473",
        "9781460764824",
        "9781460764831",
        "9780008649555",
        "9780063113930",
        "9781761180552",
        "9781922610751",
        "9781760657048",
        "9781761180361",
        "9781761345050",
        "9780734422163",
        "9780702268656",
        "9781761180682",
        "9781761294631",
        "9781760526719",
        "9781763571808",
        "9798765670248",
        "9780702268632",
        "9780500653630",
        "9780143777687",
        "9781760655341",
        "9780733343360",
        "9781922033109",
        "9781761524622",
        "9781760266042",
        "9781922539731",
        "9780063076518",
        "9780593528457",
        "9781761381010",
        "9781761181160",
        "9781760994471",
        "9781922800893",
        "9781338859317",
        "9781761211966",
        "9781035068326",
        "9781529525229",
        "9781529512366",
        "9781922539922",
        "9781760266479"
    ]
}
